hello
    ## ##             
    #   #             
    #X  #             
  ###  X###           
  #  X  X #           
### # ### #     ######
#   # ### #######  OO
# X  X             OO#
##### #### #P####  OO#
    #      ###  ######
    ########