    #########       
  ###   ##  #####   
###      #  #   ####
#  XX #X #  #  OOO #
# #  X#PX## # #O#O #
#  ## #X  #    OOO #
# X#    X # # #O#O #
#    ##  ##X X OOO #
# X ##   #  #X#O#O #
## XX  X   X  XOOO #
 #X  ######    ##  #
 #   #    ##########
 #####