          ####     
     #### #  #     
   ###  ###X #     
  ##   P  X  #     
 ##  X XX## ##     
 #  #X##     #     
 # # X XX # ###    
 #   X #  # X #####
####    #  XX #   #
#### ## X         #
#O    ###  ########
#OO OO# ####       
#OOO#O#            
#OOOOO#            
#######