#####         
#   ##        
#    #  ####  
# X  ####  #  
#  XX X   X#  
###P #X    ## 
 #  ##  X X ##
 # X  ## ## O#
 #  #X##X  #O#
 ###   XOO##O#
  #    #O OOO#
  # XX #OOOOO#
  #  #########
  #  #        
  ####