       ####      
    ####  #      
   ##  #  #      
   #  X X #      
 ### #X   ####   
 #  X  ##X   #   
 #  # P X # X#   
 #  #      X ####
 ## ####X##     #
 # X#OOOOO# #   #
 #  XOOO O X# ###
##  #OOOOO#   #  
#   ### #######  
# XX  #  #       
#  #     #       
######   #       
     #####