       #######    
 #######     #    
 #     # XPX #    
 #XX #   #########
 # ###OOOOOO##   #
 #   XOOOOOO## # #
 # ###OOOOOO     #
##   #### ### #X##
#  #X   #  X  # # 
#  X XXX  # X## # 
#   X X ###XX # # 
#####     X   # # 
    ### ###   # # 
      #     #   # 
      ########  # 
             ####