################ 
#              # 
# # ######     # 
# #  X X X X#  # 
# #   XPX   ## ##
# # #X X X###OOO#
# #   X X  ##OOO#
# ###XXX X ##OOO#
#     # ## ##OOO#
#####   ## ##OOO#
    #####     ###
        #     #  
        #######