      ############    
      #  O  ##   #    
      # #O     P #    
 ###### ##OOO# ####   
##  ##OOO####     ####
# X ##OOO    X #  X  #
#     OO ## # ## ##  #
####X###X# X  #   # ##
 ###  #    ##X XX # # 
 #   XX # # X # X## # 
 #                  # 
 #################  # 
                 ####