   ##########        
   #OOOOOOOO####     
   #O#O#OOOO#  #     
   #OOOOOOOOXX #     
   #     O###  ####  
 #########  X #   #  
 #     X   X X  X #  
 #  #    #  X X#  #  
 ## #####   #  #  #  
 # X     #   #### #  
##  X#   # ##  #  #  
#    ##X###    #  ## 
# X    X #  #  #   # 
#####    # ## # ## ##
    #X# #  X  X X   #
    #P#  X#XXX  #   #
    ###  X      #####
      ##  #  #  #    
       ##########