   ##########   
   #OO  #   #   
   #OO      #   
   #OO  #  #### 
  #######  #  ##
  #            #
  #  #  ##  #  #
#### ##  #### ##
#  X  ##### #  #
# # X  X  # X  #
# PX  X   #   ##
#### ## ####### 
   #    #       
   ######