                #####   
       ###### ###   ####
   #####    ### X X  X #
####  ## #X X    X #   #
#OOOO   XX X X  X   #X##
#OO # ## #   ###X## #  #
#OOOO    # ###    #    #
#OOOO    # ##  X  ###X #
#OO######  X  #  #### ##
####    #   ###    P  # 
        ###############