               ####    
          ######  #####
    #######       #   #
    #      X X ## # # #
    #  #### X  #     O#
    #      X # # ##O#O#
    ##X####X X X ##O#O#
    #     #    ####O###
    # X   ######  #O#O#
######XXX##      P#O#O#
#      #    #X#X###O O#
# #### #XXXXX    # OOO#
# #    X     #   # OOO#
# #   ## ##     ###OOO#
# ######X######  ######
#        #    #  #     
##########    ####