 #################     
 #OOO   #    #   ###   
##OOOOO  X## # # X #   
#OOOOOO#  X  #  X  #   
#OOOOOO#  #  # # # ##  
######### X  X # #  ###
  #     #X##X ## ##   #
 ##   X    # X  X   # #
 #  ## ### #  #####X# #
 # X XX     X   X     #
 # X    X##X ######## #
 #######  P ##      ###
       ######