#########      
#       #      
#       ####   
## #### #  #   
## #P##    #   
# XXX X  XX#   
#  # ## X  #   
#  # ##  X ####
####  XXX X#  #
 #   ##   OOOO#
 # #   # #OO O#
 #   # # ##OOO#
 ##### X  #OOO#
     ##   #####
      #####