       #######           
       #  #  ####        
       # X#X #  ##       
########  #  #   ########
#OOOO  # X#X #  X#  #   #
#OOOO# #     #X  #      #
#OO#O    X#  # X    #X  #
#OOO P##  #X #X  #  #   #
#OOOO ## X#     X########
########  #XX#X  #       
       # X#  #  X#       
       #  #  #   #       
       ####  #####       
          ####