############  ######
#   #    #P####OOOO#
#   XX#       OOOOO#
#   # ###   ## OOOO#
## ## ###  #   OOOO#
 # X X     # ## ####
 #  X X##  #       #
#### #  #### ## ## #
#  # #X   ## ##    #
# X  X  # ## #######
# # X X    # #      
#  X ## ## # #      
# XX     XX  #      
## ## ### X  #      
 #    # #    #      
 ###### ######