 #########    
 #OOOO   ##   
 #O#O#  X ##  
##OOOO# # P## 
# OOOO#  #  ##
#     #X ##X #
## ###  X    #
 #X  X X X#  #
 # #  X X ## #
 #  ###  ##  #
 #    ## ## ##
 #  X #  X  # 
 ###X X   ### 
   #  #####   
   ####