              ###      
             ##O###    
             #OOOO#    
 #############OOOO#    
##   ##     ##OOOO#####
#  XX##  X P##OOOO    #
#      XX X#  OOOO#   #
#  X ## XX # #OOOO#  ##
#  X ## X  # ## ###  # 
## ##### ###         # 
##   X  X ##### ###  # 
# X###  # ##### # #### 
#   X   #       #      
#  X #X X X###  #      
# XXX# X   # ####      
#    #  XX #           
######   ###           
     #####