     ####         
   ###  ##        
####  X  #        
#   X X  ####     
# X   # X   # ####
#  #  #   X # #OO#
##X#X ####X####OO#
 #   ##### ## OOO#
 #X# ##P## ##  OO#
 # #    X     OOO#
 #   #### ###  OO#
 ### ## #  ## OOO#
  ##X ####X ###OO#
  #   ##    # #OO#
 ## XX##  X # ####
 #     XXXX #     
 # X ###    #     
 #   # ######     
 #####