###########          
#OOOOOO   #########  
#OOOOOO   #  ##   #  
#OO### X    X     #  
#OOO X X #  ###   #  
#OOO#X#####    #  #  
###    #   #X  # X###
  #  XX X X  X##  X #
  #  X   #X#  ##    #
  ### ## #  X #######
   #  X X ## ##      
   #    X  X  #      
   ##   # #   #      
    #####P#####      
        ###          