 #####        
 #   #######  
 # X ###   #  
 # X    XX #  
 ## ####   #  
### #  # ###  
#   #  #P##   
# XX    X #   
#   # # X ####
##### #   #  #
 #   X####   #
 #  X     X  #
 ##   ##### ##
 ##########  #
##OOOO# X  X #
#OOOOO# XX#  #
#OO OO# X  X #
#OOOOOX   #  #
##  ##########
 ####