############
##     ##  #
##   X   X #
#### ## XX #
#   X #    #
# XXX # ####
#   # # X ##
#  #  #  X #
# X# X#    #
#   OO# ####
####OO X #P#
#OOOOO# X# #
##OOOO#  X #
###OO##    #
############