      #### 
####### P# 
#     X  # 
#   X## X# 
##X#OOO# # 
 # XOOO  # 
 # #O O# ##
 #   # #X #
 #X  X    #
 #  #######
 ####