      ############ 
     ##OO    #   # 
    ##OO  X    X # 
   ##OO O# # #X ## 
   #OO O# # # X  # 
####OOO#  #    # # 
#  ## #          # 
# PX X ###  # # ## 
# X   X   # #   #  
###XX   # # # # #  
  #   X   # # #####
  # X# #####      #
  #X   #   #   #  #
  #  ###   ##     #
  #  #      #    ##
  ####      ######