        #######    
    #####  #  #### 
    #   #   X    # 
 #### #XX ## ##  # 
##      # #  ## ###
#  ### X#X  X  X  #
#OOO    # ##  #   #
#OOO#    P # ### ##
#OOO#  ###  X  X  #
######## ##   #   #
          #########