    ############ 
    #          ##
    #  # #XX X  #
    #X #X#  ## P#
   ## ## # X # ##
   #   X #X  # # 
   #   # X   # # 
   ## X X   ## # 
   #  #  ##  X # 
   #    ## XX# # 
######XX   #   # 
#OOOO#  ######## 
#O#OOO ##        
#OOOO   #        
#OOOO   #        
#########