           #####    
          ##   ##   
         ##     #   
        ##  XX  #   
       ## XX  X #   
       # X    X #   
####   #   XX ##### 
#  ######## ##    # 
#OO           XXXP# 
#O# ####### ##   ## 
#O# #######O #X X###
#OOOOOOOOOOO #   X #
##############  X  #
             ##  ###
              ####