      ######             
   #####   #             
   #   # # #####         
   # X #  X    ######    
  ##X  ### ##       #    
###  XX X X #  ##   #####
#       X   ###### ##   #
#  ######## #P   # #  # #
## ###      #### #X# #  #
 # ### #### ##OO #   X ##
 #  X  X  #X##OO #X##  ##
 #  # # #     OO## ## X #
 ####   # ## #OO#    X  #
    #####    #OO# # #  ##
        ######OO#   # ## 
             #OO#####  # 
             #OO       # 
             ##  ###  ## 
              #########