    #########  ####   
    #   ##  ####  #   
    #   X   #  X  #   
    #  # ## #     ####
    ## X   X XX# #   #
    ####  #  # X X   #
#####  ####    ###OOO#
#   #X #  # ####OOOOO#
#      #  # # ##OOOOO#
###### #  #X   ###OOO#
   #   ## # X#   #OOO#
  ##       X  X# #####
 ## XXX##  # X   #    
 #   #  # ###  ###    
 #   X  #X P####      
 #####  #   #         
     ########