 #####             
 #   #             
 # # ######        
 #      XP######   
 # X ##X ###   #   
 # #### X    X #   
 # ##### #  #X ####
##  #### ##X      #
#  X#  X  # ## ## #
#         # #OOO# #
######  ###  OOO  #
     #### # #OOO# #
          # ### # #
          #       #
          #########