       ####     
       #  ##    
       #   ##   
       # XX ##  
     ###X  X ## 
  ####    X   # 
###  # #####  # 
#    # #OOOOX # 
# #   X OOOO# # 
#  X # #O OO# # 
###  #### ### # 
  #### PX  ##X##
     ### X     #
       #  ##   #
       #########