##########    
#        #### 
# ###### #  ##
# # X X X  X #
#       #X   #
###X  XX#  ###
  #  ## # X## 
  ##X#   X P# 
   #  X X ### 
   # #   X  # 
   # ##   # # 
  ##  ##### # 
  #         # 
  #OOOOOOO### 
  #OOOOOOO#   
  #########