   ##########
   #  ###   #
   # X   X  #
   #  ####X##
   ## #  #  #
  ##  #O    #
  #  ##OO#  #
  # P #O # ##
  # #X#OO#X #
  # X #OO#  #
  # # #  #  #
  # X #OO#X##
  #    O #  #
 ###  #  #  #
##    ####  #
#  #######X##
# X      X  #
#  ##   #   #
#############