##### ####      
#OOO# #  ####   
#OOO###  X  #   
#OOOO## X  X### 
##OOOO##   X  # 
###OOO ## X X # 
# ##    #  X  # 
#  ## # ### ####
# X # #X  X    #
#  X P X    X  #
#   # X XX X ###
#  ######  ###  
# ##    ####    
###