     #############   
     #    ###    #   
     #     X X  #### 
   #### #   X X    # 
  ## X  #X#### X X # 
###   # #   ###  X # 
# X  X  #  X  # #### 
# ##X#### #X#  X  ###
# ##  ### # # #  X  #
#    PX   X   # X # #
#####  #  ##  # X#  #
  #OOO #####X  #  # #
  #OOOOOOO# XX #X # #
  #OOOOOOO#         #
  #OOOOOOO#######  ##
  #########     ####