 ##################### 
 #   ##  #   #   #   # 
 # X     X   X   X   ##
##### #  #   ### ##X###
#   # ##X######   #   #
# X   # OOOOOO#   # X #
## #  # OOOOOO#####   #
## #########OO#   # ###
#          #OO# X   #  
# ## ### ###OO## #  ###
# #   #   ##OO## ###  #
#   P      XOO#       #
# #   #   ##  #   ##  #
##### ############## ##
#          #   #    X #
# X  # X X X   # #    #
# #X## X#  ## ##    # #
#  X XX #### X  X # # #
#          #   #      #
#######################