 #####################
##                   #
#    X #      ## #   #
#  ###### ###  #X## ##
##X#   ##X#OOOO   # # 
#  #    X #OOOO## # # 
# X # # # #OOOO##   # 
# X #XX   #OOOO##X# # 
# # XPX##X#OOOO##   # 
#   XXX   #OOOO#    # 
#  X#   # ###### X### 
##  # ###XX  X   X #  
##     # X  X ##   #  
 #####   #   #######  
     #########