 ####                
##  #####            
#       # #####      
# X###  ###   #      
#OO#  X# #  # #      
#OO#      XX# ###    
#O # #  #X X    #####
#OO#  ##     ##X#   #
#O X  X # ##  X     #
#OO##  X   #   ######
#O ##X##   #####     
#OO  X #####         
#  # P #             
########