        #####             
        #   ####          
        # X    ####  #### 
        #   # X#  ####  # 
########### #   X   #   # 
#OO     # X  #### #  #  # 
#OOX  #   X  #  X # X O## 
#O # # X X ##  ##    #O#  
#OO#X P #   ##    XX #O#  
#OO# X X  X X ##   ## O#  
#O XX # ##   X #X# X #O#  
#OO#      ##   #     #O#  
#OO#######  ### ######O## 
# XX                   O##
#  ##################  OO#
####                ######